30 36
####################################
#                  ###         #####
# #### ###########     #######     #
# #### #           ###     # # ### #
# P      #########     # # ### # # #
# ##### ###      ### ### # #P# # # #
# #   #   #        # ### # # # # # #
# #   # # #        # ### #   # # # #
# ##### # ########## ### ##### ### #
#                        ..        #
# ####### ######## ##BBB## ## #### #
# ##   ## ######## ##BBB## ## #P## #
# ##   ## ##    ## ##BBB## ####### #
# ####### ##    ##     ### ####### #
# ####### ##    ##     ###   ###   #
#      ## ########     ###   ###   #
# ####### ######## #######   ###   #
#                                  #
# ###### ### ########## ###### ### #
# #    # ### #####   #         # # #
# ######         ##### ### ### # # #
#        #######       # # # # # # #
# ###### #     ##### ### # # # ### #
# #    # ########### ##### ###     #
# ###### #     P             # ### #
#          ######### ####### # # # #
# ####### ########## #     #   # # #
# #######            ####### # ### #
#         ##########         #     #
####################################
